1111111111111-
6414441444411-
1414141411411-
1414141411411-
1414141411447-
1444144411111-
1111111111111