11111111111111-
64144414444111-
14141414114111-
14141414114111-
14141414114111-
14441444114447-
11111111111111-
11111111111111