1111111111111-
4414441444411-
1414141411411-
1414141411411-
1414141411444-
1444144411111-
1111111111111