1111111111111111111-
4414441444411144411-
1414141411411141411-
1414141411411141411-
1414141411411141444-
1414141411411141111-
1444144411444441111-
1111111111111111111