111111111111111111-
641444144441444447-
141414141141411111-
141414141141444441-
141414141141111141-
144414441144444441-
111111111111111111-
111111111111111111