22272222222222-
22252255555522-
22252252222522-
22252252255522-
22255552252222-
22222222255556-
22222222222222-
22222222222222